..................................................
.                                                .
.                                                .
.                                                .
.                                                .
.                                                .
.                                                .
.                                                .
.              ///                               .
.                                                .
.                                                .
.                                                .
.                                                .
.                                                .
.                 ///                            .
.                                                .
.                                                .
.                                                .
.                                                .
.                                                .
.                                                .
.                                                .
.                                                .
.                                                .
.                                                .
.                                                .
.                                                .
.                                                .
.                                                .
.                                                .
.                                                .
.                                                .
.                                                .
.                                                .
.                                                .
.                                                .
..................................................